_______________________________________________
_______________________________________________
_______________________________________________
############___________________________########
___________#___________________________________
___________#___________________________________
___________#___________________________________
___________#___________________________________
___________#___________________________________
___________#___________________________________
___________#___________________________________
___________#___________________________________
############___________________________########
_______________________________________________
_______________________________________________
_______________________________________________
